5
6
0120000000
0111101111
0000100001
0101111101
0101100001
0101101111
0111100111
0000000000
0111010110
0000000110
